a,b,c,d,e,f,g,h
🌳,🚪,🌳,🌳,🌳,🌳,🌳,🌳
🌳,⏹,_,_,_,_,_,🌳
🌳,🌳,🌳,🌳,_,_,_,🌳
🌳,💰,_,_,_,🪦,_,🌳
🌳,🌳,🌳,🌳,_,_,_,🌳
🌳,🦀,_,_,_,_,_,🌳
🌳,🌳,🌳,🌳,🌳,▶️,🌳,🌳
🌳,🌳,🌳,🌳,🌳,🚪,🌳,🌳