a,b,c,d,e,f,g,h
🌳,🚪,🌳,🌳,🌳,🌳,🌳,🌳
🌳,1,1,1,1,1,1,🌳
🌳,🌳,🌳,🌳,1,1,1,🌳
🌳,💰,1,1,1,1,1,🌳
🌳,🌳,🌳,🌳,1,1,1,🌳
🌳,🦀,1,1,1,1,1,🌳
🌳,🌳,🌳,🌳,🌳,🌳,🌳,🌳
🌳,🌳,🌳,🌳,🌳,🌳,🌳,🌳